##S#########################################
## ###########                      ########
##             ####################     ####
## ########### #######           ###########
##    ######## ####### ######### ###      ##
#### ######### ####### ######### ### #### ##
   # #########         ######### ###   ## ##
 ### ########################### ##### ## ##
         ###### ### ############       ## ##
 #######              ###################  #
##########################################E#
